xxxxxxxxx
x H     x
x x xxx x
x x x   x
x   x x x
  x     x
 xxx xx x
  x     x
x   x x x
xxxF  F x
xxx xxx x
xxx xxx x
xxx     x